Maryann	Fletcher
Mercedes	Ward
Chad	Sullivan
Dale	Campbell
Darrin	Terry
Rex	Gibson
Marshall	Marsh
Raquel	Houston
Louise	Wise
Franklin	Ford
Shawn	Hoffman
Bernard	Wells
Grady	Bell
Cindy	Barrett
Emilio	Blake
Annie	Goodman
Russell	Chambers
Betsy	Lynch
Owen	Webster
Glenda	Sutton
Erin	Roy
Florence	Blair
Earnest	Green
Lindsey	Hodges
Miranda	West
Joel	Garza
Marc	Jordan
Marsha	Parsons
Flora	Little
Colleen	Hill
Ben	Cole
Rosemarie	Howard
Ivan	Phelps
Ida	Palmer
Gertrude	Steele
Ignacio	Martin
Roman	Woods
Lee	Ellis
Leonard	Padilla
Alexander	Jennings
Katie	Perry
Milton	Young
Troy	Hansen
Clark	Boyd
Jody	Murray
Whitney	Owens
Dominic	George
Roderick	Cox
Sandy	Park
Emmett	Brooks
Ethel	Page
Isaac	Vargas
Silvia	Sanchez
Noah	Bass
Irvin	Silva
Timmy	Smith
Bradley	French
Eloise	Harper
Edwin	Carroll
Frank	Wade
Angel	Byrd
Krystal	Higgins
Patty	Boone
Sophie	Baker
Laura	Jensen
Pat	Crawford
Roxanne	Lambert
Dominick	Castillo
Sammy	Cummings
Adrienne	Frazier
Henry	Ball
Maria	Bush
Della	Newton
Christina	Webb
Simon	Rogers
Fannie	Lopez
Carroll	Shelton
Sheryl	Valdez
Luke	Thomas
Allan	Cunningham
Lynne	Maldonado
Leah	Santos
Lynn	Williamson
Samuel	Dennis
Jana	Perez
Clyde	Morrison
Melinda	Pena
Gilbert	Kelly
Tommie	Neal
Cedric	Reed
Tom	Rivera
Clifton	Sims
Willie	Ramos
Casey	Parker
Mable	Alexander
Bryan	Powell
Yvonne	Shaw
Melissa	Roberson
Darlene	Colon
Kelly	Norton
Patsy	May
Ashley	Walters
Maureen	Harper
Felipe	Perry
Conrad	Payne
Gertrude	Schmidt
Ray	Bradley
Vicky	Richards
Omar	Hodges
Marco	Smith
Joe	Graham
Melvin	Reed
Erick	Mcguire
Bethany	West
Harvey	Watkins
Charles	Simon
Deborah	Hubbard
Ella	Armstrong
Terence	Cobb
Katrina	Saunders
Jeffrey	Gilbert
Joyce	Cannon
Johnnie	Osborne
Sabrina	Munoz
Walter	Mccormick
Tony	Marsh
Eduardo	Wagner
Becky	Ford
Elsie	Roberts
Jennifer	Kelly
Christie	Moran
Preston	Joseph
Glen	Sharp
Flora	Phillips
Claire	Leonard
Kristine	Aguilar
Carolyn	Robertson
Hannah	Collins
Jeannette	Jenkins
Silvia	Fletcher
Domingo	Little
Kenneth	Moreno
Rex	Blair
Terry	Farmer
Cristina	Patrick
Joan	Elliott
Kristy	Holmes
Carroll	Mckinney
Pearl	Caldwell
Vivian	Ballard
Tiffany	Wilkerson
Essie	Montgomery
Ivan	Ingram
Jill	Price
Lucas	Ruiz
Kelley	Curtis
Jeff	Hunter
Willard	Torres
Carl	Jefferson
Kathryn	Bush
Brittany	Green
Arthur	Chambers
Wanda	Hughes
Zachary	Wilkins
Nicolas	Holland
Wilbur	Potter
Marcia	Fernandez
Johnny	Erickson
May	Lloyd
Jimmie	Lucas
Alison	Carlson
Danielle	Burgess
Deanna	Jimenez
Ora	Bennett
Sheila	Clayton
Marjorie	Nichols
Patrick	Hansen
Jenna	Strickland
Joann	Andrews
Austin	Nash
Juana	Nunez
Charlie	Rogers
Maggie	Mcdonald
Lynn	Long
Sean	Horton
Angela	Patton
Ellen	Edwards
Virgil	Phelps
Kellie	Holt
Camille	Reid
Janet	Benson
Jack	Pierce
Carole	Fuller
Frankie	Garza
Trevor	Robbins
Mabel	Castillo
Darin	Gutierrez
Amy	Ball
Bradley	Carpenter
Gordon	Brock